25 25
5 6
WWWWPPPPPPPPPPPPPPPWWWWWW
WPPPPWWWWWWWWWWWWWPWWWWWW
WPPPPPPPPPPPPPPPPPPWWWWWW
WWWWWWPWWWWPWWWWPWWWWWWWW
WWWWWWPWPPPPPPPPPWWWWWWWW
WWWWPPPPPWWWWWWWWPPPPPWWW
WWWWWWPWWWWWWWPPPPWPWWEWW
WWWWWWPPPPPPPPPWWPPPWWPWW
WWPPPPPWWWWWWWWWWWWWWWPWW
WWPWWWPPPWWWWWPPPPWWPPPWW
WWPPPWWWWWWWWWPWWPPPPPPWW
WWPPPWWWWWWWWWPPPPWWPPPWW
WWPPPWWWWWWPPPWWWWWWWWPWW
WWWPWWWWWWWPWWWWWWWWWWPWW
WWWPPPWWWPPPPPWWWWWWWWPPP
WWWPPPWWWPPPPPWWWWWWWWWWP
WWWPPPWWWPPPPPWWWWWWWWPPP
WWWPWWWWWPPPPPWWWWWWWWPWW
WWWPPPPPPPPPPPWWPPPWWWPWW
WWWPWWWWPWWPWWWWPWPWPPPWW
WWPPPPPPPWWPPPPPPWPPPWWWW
WWPPWWWWWWWWPWWPWWWWWWWWW
WWWWWWWWWWWWPWWPWWWWWWWWW
WWWWWWWWWWWWPPPWWWWWWWWWW
WWWWWWWWWWWWWPWWWWWWWWWWW 
