20 20
9 8
WWWWWWWWWWWWWWWWWWWW
WWWWWWWWWWWWWWWWWWWW
WWWWWWWWPWWWWWWWWWWW
WWWWWWWWPWWWWWWWWWWW
WWWWWWWWPPPWWWWWWWWW
WWWWWWWWPWWWWWWWWWWW
WWWWPPPPPWWWWWWWWWWW
WWWWPWWWPWWWWWWWWWWW
WWWWPWWWPWWWWWWWWWWW
WWPPPPWWPPPPPWWWWWWW
WWPWWPWWWWWWPWWWWWWW
WWPPPPPPPPWWPWWWWWWW
WWPWWWWWWPPPPWWWWWWW
WWPWWWWWWWWWWWWWWWWW
WWPWWWWWWWWWWWWWWWWW
WWPEPPPPPPPPPPPPWWWW
WWPPPPPPPPPPPPPPPWWW
WWWWWWWWWWWWWWWWWWWW
WWWWWWWWWWWWWWWWWWWW
WWWWWWWWWWWWWWWWWWWW 
