6 9
0 0
PPWWWPWWW
WPPPPPPWP
WWWPWWPPW
WPPPWWPWW
WWPWWWWEW
WWPPPPPPW 
